15 -12 3 1 1
16 -12 3 1 1
29 -12 3 1 1
46 -12 4 1 1
48 -12 4 1 1
60 -12 4 1 1
62 -12 3 1 1
63 -12 3 1 1
73 -6 3 1 1
77 -8 3 1 1
78 -8 3 1 1
91 -12 3 1 1
92 -12 3 1 1
93 -12 3 1 1
136 -8 3 1 1
137 -8 3 1 1
150 -12 4 1 1