11 -12 21 0 0
1 -13 23 1 1
2 -13 23 1 1
3 -13 23 1 1
4 -13 23 1 1
5 -13 23 1 1
6 -13 23 1 1
7 -13 23 1 1
8 -13 23 1 1
9 -13 23 1 1
10 -13 23 1 1
11 -13 23 1 1
12 -13 23 1 1
13 -13 23 1 1
14 -13 23 1 1
15 -13 23 1 1
16 -13 23 1 1
17 -13 23 1 1
18 -13 23 1 1
19 -13 23 1 1
20 -13 23 1 1
