23 -12 3 1 1
45 -12 3 1 1
50 -12 3 1 1
52 -12 3 1 1
81 -4 3 1 1
83 -4 3 1 1
100 -12 3 1 1
101 -12 3 1 1
120 -12 3 1 1
122 -12 3 1 1
126 -12 3 1 1
127 -12 3 1 1
129 -12 3 1 1
176 -12 3 1 1
177 -12 3 1 1
108 -10 4 1 1 Default