14 -12 21 0 0
14 -12 21 0 0
1 -13 6 0 1
2 -13 6 0 1
3 -13 6 0 1
4 -13 6 0 1
5 -13 6 0 1
6 -13 6 0 1
7 -13 6 0 1
8 -13 6 0 1
9 -13 6 0 1
10 -13 6 0 1
11 -13 6 0 1
12 -13 6 0 1
13 -13 6 0 1
14 -13 6 0 1
15 -13 6 0 1
16 -13 6 0 1
17 -13 6 0 1
1 -2 6 1 1
1 -3 6 1 1
1 -4 6 1 1
1 -5 6 1 1
1 -6 6 1 1
1 -7 6 1 1
1 -8 6 1 1
1 -9 6 1 1
1 -10 6 1 1
1 -11 6 1 1
1 -12 6 1 1
4 -9 6 1 1
5 -9 6 1 1
6 -9 6 1 1
7 -9 6 1 1
8 -9 6 1 1
9 -9 6 1 1
10 -9 6 1 1
11 -9 6 1 1
12 -9 6 1 1
13 -9 6 1 1
4 -2 6 1 1
4 -3 6 1 1
4 -4 6 1 1
4 -5 6 1 1
5 -2 6 1 1
5 -3 6 1 1
5 -4 6 1 1
5 -5 6 1 1
6 -2 6 1 1
6 -3 6 1 1
6 -4 6 1 1
6 -5 6 1 1
7 -2 6 1 1
7 -3 6 1 1
7 -4 6 1 1
7 -5 6 1 1
8 -2 6 1 1
8 -3 6 1 1
8 -4 6 1 1
8 -5 6 1 1
9 -2 6 1 1
9 -3 6 1 1
9 -4 6 1 1
9 -5 6 1 1
10 -2 6 1 1
10 -3 6 1 1
10 -4 6 1 1
10 -5 6 1 1
11 -2 6 1 1
11 -3 6 1 1
11 -4 6 1 1
11 -5 6 1 1
12 -2 6 1 1
12 -3 6 1 1
12 -4 6 1 1
12 -5 6 1 1
13 -2 6 1 1
13 -3 6 1 1
13 -4 6 1 1
13 -5 6 1 1
14 -2 6 1 1
15 -2 6 1 1
14 -3 6 1 1
15 -3 6 1 1
14 -4 6 1 1
15 -4 6 1 1
14 -5 6 1 1
15 -5 6 1 1
14 -6 6 1 1
15 -6 6 1 1
14 -7 6 1 1
15 -7 6 1 1
14 -8 6 1 1
15 -8 6 1 1
14 -9 6 1 1
15 -9 6 1 1
14 -10 6 1 1
15 -10 6 1 1
4 -12 9 1 0
5 -12 9 1 0
6 -12 9 1 0
7 -12 9 1 0
8 -12 9 1 0
9 -12 9 1 0
10 -12 9 1 0
11 -12 9 1 0
12 -12 9 1 0
5 -8 9 1 0
6 -8 9 1 0
7 -8 9 1 0
8 -8 9 1 0
9 -8 9 1 0
10 -8 9 1 0
11 -8 9 1 0
12 -8 9 1 0
